// Level 1-2: Sa Cova des Foner (The Slinger's Cave)
// 70 x 15 tiles
// Legend: . = air, # = solid, - = one-way, X = hazard, B = breakable, P = player, C = companion
#.....#################################################################################################
#.....#################################################################################################
#.....################################################........#########################################
#.........#####################.......################.........#...............########################
#..............############.............##############....###.......................###################
#.................#######.................############...#.............................################
#.....................#.......................########...#...............................##############
#...................................................##...#######.............................##########
#........................................................#.......................................######
#......................................................................................................
#...............................................#########............................##....############
#............................................................................##########################
#.P........................................................................############################
###################################...##..#############################################################
###################################...##..#############################################################
