// Level 1-4: Sa Porta des Bou (The Bull's Gate)
// 80 x 18 tiles
// Legend: . = air, # = solid, - = one-way, X = hazard, B = breakable, P = player, C = companion
#..............................................................................#
#..............................................................................#
#..............................................................................#
#..............................................................................#
#..............................................................................#
#..............................................................................#
#..............................................................................#
#..............................................................................#
#..............................................................................#
#..............................................................................#
#..............................................................................#
#..............................................................................#
#..............................................................................#
#...........................#########.....................#########............#
#CP............................................................................#
#..............................................................................#
######################..##########################..############################
######################..##########################..############################
