// Level 1-3: Es Talayot Sagrat (The Sacred Talayot)
// 24 x 30 tiles
// Legend: . = air, # = solid, - = one-way, X = hazard, B = breakable, P = player, C = companion
#......................#
#......................#
#......................#
#......................#
################.......#
#......................#
#......................#
#......................#
#..........#############
#......................#
#......................#
#......................#
##############.........#
#......................#
#......................#
#......................#
#.......################
#......................#
#......................#
#......................#
#############..........#
#......................#
#......................#
#......................#
#...........############
#......................#
#.CP...................#
#......................#
########################
########################
