// Level 1-1: Es Primer Pas (The First Step)
// 60 x 15 tiles
// Legend: . = air, # = solid, P = player spawn, C = companion spawn
#...........................................................
#...........................................................
#...........................................................
#...........................................................
#............................#...#..........................
#............................#...#..........................
#............................#...#..........................
#............................#...#..........................
#............................#...#..........................
#............................#...#..........................
#............................#...#..........................
#CP.........................................................
#.............###...........................................
####################..######################################
####################..######################################
