// Level 2-1: Sa Via Nova (The New Road)
// 40 x 14 tiles
// Legend: . = air, # = solid, - = one-way, X = hazard, B = breakable, P = player, C = companion
########################################
#...........#............#.............#
#...........#............#.............#
#...........#............#.............#
#...........#............#.............#
#...........#............#.............#
#...........#............#.............#
#...........#............#.............#
#...........#............#.............#
#.......---.#.....#####..#.............#
#CP.........#............#.............#
#...........BBB..........BBB...........#
########################################
########################################
